R        1000 1000
NO   ./text/purplestone.xpm 

WE ./text/greystone.xpm

SO    ./text/redbrick.xpm   

EA   ./text/bluestone.xpm  


C  255, 255, 255

S   ./text/coin1.xpm 

F   0, 0     ,     0
11111  
 1111111111111111
10E00000000000001
10010111100010001
10000001010001001
10001000010000001
10000000000000001
10001111110001001
10222000000000101
10000000122222101
10000001000000001
11111111111111111
