R 1080 720

NO         textures/bluestone.xpm
SO textures/colorstone.xpm

WE textures/greystone.xpm
EA textures/redbrick.Xpm

S    textures/barrel.xpm
F 52,52,32
C 135,190,255

         111111111111111111111111
        1000000000110000000000001
        1011000001110000002000001
        100120000000000020S000001
111111111011000001110000000000001
10200000000000000111100020000000111111111
11110111111111011100000010011000000000001
11110111111111011101010010000000000000001
11000000110101011100000010001111100111111
10002000000000000000000010001000000000001
10000000000002001101010000011111100111111
1122000111010101111101111001100000000001
11110111 1110100000111101000000000000001
111111     11111111111111111111111111111
