R 720 480
NO ./textures/colorstone.xpm
SO ./textures/bluestone.xpm
WE ./textures/greystone.xpm
EA ./textures/wood.xpm

S ./textures/barrel.xpm
F 255,248,220
C 135,206,250

111111111111111111111111111111111111
1000000000111	0000000000000000001
1011000001111	10000002000001111111
100100000011111111000000011111
11111111101100000111000011
1000000000110000011101111
1111011111111101110000001
1111011111111101110101001
1100000011010101110000001
1000200000000000000000001
1000000000N00000110101001
1100000111010101111101101
1111011111110101110111101
1111111111111111111111111
