R 720 480
NO ./textures/colorstone.xpm
SO ./textures/bluestone.xpm
WE ./textures/greystone.xpm
EA ./textures/wood.xpm

S ./textures/barrel.xpm
F 255,248,220
C 135,206,250

111111111111111111111111111111111
111111111000000000110000000000001
111111111011000001110000002000001
111111111001000000000000000000001
111111111011000001110000000000001
100000000011000001110111111111111
111101111111110111000000100011111
111101111111110111010100100011111
110000001101010111000000100011111
10002000000000001100000010001
10000000000000001101010000011
11000001110101011111011110N0111
11110111111101011101111010001
11111111111111111111111111111
